# Level 5
         ~                  
         ~       $      E   
###      ~      ####H#######
  ##     ~     ##   H       
   ##    ~    ##    H       
$E ###   ~  $###    H   $   
##H####  ~  ####H###H#######
  H   ## ~ ##   H           
  H$E  ##H##    H     $     
H###H    H     #H##H###     
H   H              H        
H   H    $     E   H        
H   H#######H######H#####H##
H           H            H  
H           H  P         H  
############################
