# Level 6
##################~#########
# $               ~# E $   #
#T###H####H       ~#######H#
#T###H############## ###  H#
#    H  $ E     #### ###  H#
#H#########H######## ###  H#
#H   ######H#####$$# ###$ H#
#H   ######H##############H#
#H   #    $H    $  E   $ #H#
#H   ###H#######H#######H#H#
#H  $###H       H#######H#H#
#H##T#  H    P  H  ##   H#H#
#H##T#H#####H########$$ H#H#
#H##T#H#####H######$######H#
#HE   H##$##H    $  E     H#
############################
