# Level 9
~                           
~---------------------------
H# E   #             #     #
H #####               ##### 
H # ###               #$### 
H ##### E    E      E ##### 
H ### #T################# # 
H #####T### $## $########H# 
H #####T#################H# 
H #####T#################H# 
H #####T####    #########H# 
H #####T####    #########H# 
H #####T####   $H########H# 
H~-----~----####H--------H  
H          =====            
H      P  =====    E        
