# Level 10
          $              ~  
        H#######  $      ~  
    $   H      ######    ~  
##########H         $    ~  
          H######~#####H##  
E         H      ~     H    
##########H      ~ E   H   $
##########H#######==   H####
##########H            H    
##########H       $ ---H    
##      ##H       ##   H    
##  $$  ##H     $      H    
###########H#######H   H    
           H       ########H
    $    P H               H
############################
