# Level 12
      $     $           ~   
H#################H     H   
H             $   H     H  $
#########H#########     H###
########HH              H   
#######HH-------H       H   
#$ $##HH      E H  $  E H  $
#####HH     H####===####H###
     H      H           H   
     H      H           H   
    EH   $  H           H  $
H###########H  $     $  H###
H           H ######### H   
H           H           H   
H      $    H    P $    H   
############################
