# Level 16
                         ~  
                    P     ~ 
   T####HH######HHHHH      ~
         H   #  H         ~ 
    $     H H#  H        ~  
    #$     HH#  H       ~   
   ###$     H#  H      ~    
  #####$    H#  H     ~     
########    H#  H      ~    
 $#####     H#  H       ~   
   ###      H#  H        ~  
    #       H#  H         ~ 
       E    H#  H   E      ~
 H##############T######### ~
 ###############         H#~
################   $$$$$$H##
