# Level 17
~                          ~
~                          ~
~         E                ~
H###T######################H
H###T######################H
H       ##--------##       H
H   $   $#H    E $##    E  H
H       ##H ########  #####H
H  ###  ##H       ##  ##$##H
H  #$#  ##H       ##  #####H
H   P   ########HH##  ##$##H
H  ###  ########HH##  #####H
H  ###  ##      H ##       H
H  ###  ##     $H ##    $  H
##########H#########H#######
#######  $H###### $ H#######
