# Level 18
   ~                        
   ~      $         $      $
HT#H    H###H     H###H#  #H
H  ######   H#####H   H  $ H
H$ E        H     H   #### H
HT####         ###H#       H
H =####       ##        H# H
H =#####     ##       H#H  H
H =###########    $   H   ##
H =###########   ###  H     
H =    ### ###        H   E$
H =  $ ## $ ##     E  H   ##
H =H###########H######H   ##
H  H           H      H   ##
H  H       P          H   ##
############################
