# Level 19
            ~##~            
          E$H##H$E          
          H######H          
         $H######H$         
        H##########H        
      E$H##########H$E      
      H##############H      
     $H   $$$$$$$$   H$     
    H##################H    
   $H##################H$   
  H######################H  
  H######################H  
  H                      H  
  H                      H  
  H          P           H  
############################
