# Level 21
==========================~#
H----------------------H~~~#
H        ##  E         H~$ #
H  H #####################H#
H  H ###                  H#
H  H   # ###################
H  H  H#   $  # $ # $ # $  #
H  H  H##H##################
H  H--H  H##### #####      #
H  H  H  H    # $#     E   #
H  H  H  H--H ####H--#######
H  H  H  H  H     H  #######
H  H  H  H  H--H  H  #######
H  H  H  H  H  H #H### $$$ #
H  HP H  H EH  H  H###H#####
##################H $$H#####
