# Level 22
       $    $     ~        ~
$$################H        ~
##          $  $  H        ~
         H########H  $   $ ~
         H        H########~
    $ E$ H                 ~
   H######H           $    ~
   H      H      H#########H
 $ H      H      H         H
###H    E H  E $ H       $ H
      H###H######H    H#####
      H--------    $  H     
    $ H$       H######H   $ 
#######H       H      H#####
       H       H            
       H  $  P H      $     
