# Level 23
   =========           ~    
  =         =          ~ == 
 =   $$ E    #H        ~ == 
==##H########==H    E  ~$== 
=###H###########H##===#H====
=##HHH#-------#HHH#----H---H
=##H H#  $    #H H#        H
=##H H#  P    #H H# $    $ H
=##H$H####H####H$H#=      =H
=#########H################H
=      ##HHH##  $    $   $ H
=------#HH HH--------------H
= $    #H   H            E H
=       H   H  ########### H
====    H   H ### $##  $ ##H
=######=H$ $H  #############
