# Level 25
    =     =     =         ~=
    =     =     =   $     ~=
    =T####=     =####  ###~=
###         ###HE  $     $~=
###########H   H######## #H=
       P   H ##H#   $    #H=
#H#########H $#H# #####H #H=
#--------##H ##H# #    H #H=
#  #  # $##H   HH # ###H #H=
#  #  #  #HH####H##$###H #H=
#  # $#  #H#      # ###H  H=
#  ####  #H# #### #    H#HH=
#H##  ##HHH# #$## #######H =
#H   ==#HH##   #  ##$    H#=
#H   =   H##T####T#######H#=
#H###    H     E         H =
