# Level 27
H                          H
H      P            E      H
H   =#H#=----------=#H#=   H
~   =$H = $      $ = H =   ~
~ =## H ##=      =## H$##= ~
~~=$  H  $= $    = $ H #$=~~
=~### H   ##=  =#####H # #~=
=     H     = $=$    H #  $=
=     H#####=H#=##   H ## #=
= $ E H   E  H       H     =
=H####H   =##H###=   H   #H=
 H= $ H   #  H $ #   H  E=H 
 H=## H ###  H   ### H ##=H 
 H $= H =    H    $= H =$ H 
 H   ###     H      ###   H 
############################
