# Level 28
             ~              
-----------  ~              
  $    $ =H  ~ $            
#########=======H  $H=H     
#=#=#=#=====   =======H     
          ==  $      =H E$  
--------H ==#####H   ==####H
        H ==     HE    ####H
        H == ########H ####H
 $    $ H == #      #H ####H
###E  # H == #   $  #H ##$#H
####### H == ########H ## #H
        H    #  $   #H    #H
############## H##H #######H
          P    H $H        H
############################
