# Level 30
=                          ~
=     $$$$E E E      P     ~
=##########T###############H
                           H
    = $  $       $      $= H
    =#######T#######T####= H
                           H
      =  $    $     $  =   H
      =###T######T#####=   H
                           H
       =  $     $    $=    H
      ==##############=    H
                           H
                           H
$$$$    E        E      H= H
##########======########== H
