# Level 31
              ~             
              ~             
$             ~~           $
#H H-----------~--------H H#
##HH E                $ HH##
###H H------ ---------H H###
####HH $              HH####
####TH H------- ----HEHT####
####T#HH          $ HH#T####
####T##H H--- ----H H##T####
####T###HH $      HH###T####
####T####H H-- -H H####T####
####T#####HH    HH#####T####
####T######HH  HH######T####
####T#######HP$H#######T####
####E       H##H        ####
