# Level 32
~                           
###~####         ------ E   
   ~ --  E            =====H
   H#  #####H######---   # H
H####  #$---H-----#   ####H#
H      ####   ###H#   #$  H 
H      #----H----H#   #-  H 
H P#   #H$#$H$#H$H#   #   H$
#H##   ############    #H###
 H    $#     $    #     H   
 H    ##   ###H   #     H   
 H  $# #      H   #$  H#####
 H  #  #   $  H   ##  H     
 H$#   # H######H # #$H     
 H#  $ # H#  $ #H    #H     
############################
