# Level 33
#####~######################
    #~# -------            #
~##~ ~# #$   #H#         E #
~ ##### ######H#####$ #H####
#~    $---####H########H# ##
#######   #  #H### ####H# ##
       E     #H### ## #H#$ #
H#######H#H$ #H### ## #H####
H       H#####H###$ # #H## #
H         ####H###### #H##$#
H       #     H        H   #
H###H####H#=#=#=#=#=#=#H#=#=
H###H####H######  #####H#=#=
H   H    H#######  ####H    
H########H########$ #######H
HP       H $ ######  E     H
