# Level 35
~            ##            ~
~            ==            ~
~ $       $  ##  $       $ ~
=#=#=#=#=#=#H==H#=#=#=#=#=#=
   $     $  H##H  $     $   
H=#=#=#=#=#=#==#=#=#=#=#=#=H
H   $   $    ##    $   $   H
=#=#=#=#=#=#H==H#=#=#=#=#=#=
    $E E$   H##H   $E E$    
H=#=#=#=#=#=#==#=#=#=#=#=#=H
H  $     $   ##   $     $  H
=#=#=#=#=#=#H==H#=#=#=#=#=#=
  $       $ H##H $       $  
H=#=#=#=#=#=#==#=#=#=#=#=#=H
H            P             H
#=#=#=#=#=#=#=#=#=#=#=#=#=#=
