# Level 36
~   $    $     $       E$  ~
H######H### #####H### #####H
H      H         H         H
 H      H  -    H         H 
H      H  - -    H         H
 H      H-   -  H --------H 
H------H      -  H         H
    E   H-     -H         H 
###### H  -   -  H    E$ $ H
## ###  H  - -  H    -###===
 $   $ H    -    H   -###===
##T###  H  - -  H    -###===
##T# # H  -   -  H   -##$$==
  $ $   H-     -H    -======
###### H    $ P  H $  ======
############################
