# Level 37
~                           
~      E                    
~##########======#====#====H
$                     H    H
##         =   $    $---$  H
#####HH#HH########  #   #  H
    #HH HH# ==####     E   H
    #HH$HH# = #### ###H####H
    ####### =$###     H    H
                      H    H
       P       #H#####H====H
##H########H### H $$  H    H
  H        H    H ==     ##H
  H##$#    H  ### ==###### H
  H####   EH   $  ==       H
##################==###====H
