# Level 38
~                          ~
~                          ~
######H####HE EH####H#######
 -    H    H=H=H    H     - 
H #####      H   $  ###### H
H #####  #HHHHHHH#  ###### H
H ##$ #  #H=====H#  ##$### H
H #####  #HHHHHHH#  ###### H
H         -------          H
H E   H      =      H    E H
H=====H    $===$    H======H
H     H    =====    H      H
H#####H   =======   H######H
H     H $=========$ H      H
H=====H =========== H======H
$     H=============H  P   $
