# Level 40
~          #################
~          ########= ------#
~    $   H#    $   =H # $  #
#########H=####### =H ######
    $    H=    $   =H ######
H#########= ##T### =H ######
H    E$   =      $ =H  E    
#########H= ##TTT# ########H
 $       H=    $           H
H#########= ##T###         H
H  $      =      $         H
#########H= ##TTT#  #####  H
        $H=      $  #  $#  H
H#########= ##T###    H##  H
H   E       P         H# $ H
############################
