# Level 41
   ~--$ --------~-----~-----
   H $#$        H- # -H  $$$
$PH $# #$      H- ### -H  $$
## $#   #$    H- #   # -H  $
 E T  #  #   H- ##   ## -H E
H##  ###  ===-   #$$$#   -#H
H   #   #   $   HH###      H
H  - ###   $H  H##H#       H
H   - #   $H   H  H -------H
H    -   $H   H====H       H
===H  ---H    H$  $H ------H
   H         H######H      H
###H###H     H$    $H -----H
       H    H========H     H
       H  E H$   E  $H ----H
########=====########H     H
