# Level 42
~ $       $     ~    $    $~
H###    H###    H##########H
H $   $ H     $ H $    $   H
H###H###H   #####=##=###=###
H   H  EH   --------------- 
####H######H      $   $E   H
    H      H =####======###H
    H===== H =      $  $   H
#   H  $ = H =   ========= H
#$$===###= H =   =  $ $  = H
###===###= H = $ = H####H= H
  $  $     H ==T== H    H= H
#########  H =     H   EH= H
  $ $   =  H =#######===== H
######H ====####=         PH
####$#H           H#########
