# Level 44
###########################~
#   HHHHHHHHHHHHHHHHHHH   #~
# P H HHH    H   HH   H E #~
####H HHH HH H HH H HHH####~
#   H HHH HH H HH H   H   #~
# E H HHH HH H HH H HHH E #~
####H   H    H   HH   H####~
HHHHHHHHHHHHHHHHHHHHHHHHHHHH
H $ H $ H $  H  $ H $ H $ HH
HHHHHHHHHHHHHHHHHHHHHHHHHHHH
H   H H H HH H HH H   H   HH
H H H H H  H H  H H HHH H HH
H  HH H H H  H H  H   H  HHH
H H H H H HH H HH H HHH H HH
H H H   H HH H HH H   H H HH
HHHHHHHHHHHHHHHHHHHHHHHHHHHH
