# Level 45
===============  ~ =========
  EH      H---   ~ H      $ 
===~##=====#T#===~ H==== H=#
=--H       H----H  H   #####
=  H       $ #$#HE H      ##
$ TH       H    =#H ==####=#
=#TH-------H-----=H-------H=
#  T       H   $H===      H#
==T#    $$$H    H=----  $ HH
=          H    H=H     T#=H
###T##     H P  H=H $      H
#H---- H=###=##T==H        H
#H$   #H        H#H  =#### H
#H=--###H       H=H  #   = H
#H  ###=#H  E   H H   #==#==
=#####====##############=###
