# Level 46
 $                   ~      
####H            E   ~      
  $ H          H######H   $ 
########H######H     #######
        H      H $        $ 
     $  H      H############
#H######H   $  H            
 H   $  H======H      $     
#H######H      #####H######H
        H E    $    H      H
 $      H###H#######========
###H#####   H  $      $ E   
   H       H#########H######
   H-------H        H       
   H         P      H     $ 
#######################~####
