# Level 47
=               ===========~
=E        E     =  $ =     ~
==------#####H P= H= =H=###H
=#####   $  ###== H= =H=###H
=    ######       H= =H=   ~
###H      ####H $ H= =H= $ ~
# ###=#H      H###== =H=###H
#  $  ##=#H   H    = =H=###H
#####    ###=#H    = =H=   ~
# $ #=H#     ##=##H= =H=$$ ~
###   H##==#  $  =H= =H=###H
# #=##H    ###==#=H= =H=###H
#   ###=##H      =H= =H= ##H
# H##   $###==#H#=H= =H=  #H
# H#           H $H=  H   $~
#$H#=####=#####=##==##=#####
