# Level 48
~           $~        ~     
~------- ####HP       ~     
H          $ H    $   ~  $  
H        H==== #######H#####
H        H $          H     
H######H ####H        H     
H      H   $ HEH###########H
H      H H==== H===========H
H    $H# H$    H=     $   =H
H    H#  ####H H=H=======H=H
H  $H#      $H H=H=   $  H=H
H  H#    #==== H=H=========H
H H#     # $   H=H    $    H
HH#      ####H H============
HH  E        ~ H    E       
############################
