# Level 49
     -     -~-      -~ $  $ 
-   - -   - H -    - H######
 - -   - -  H  -  -  H      
  -     -   H   --   H  E   
  $  $  $   H   -    H=====H
=======T======H-     H= $ =H
              =      H=H=$=H
             $=  P $ H=H=$=H
H##########H#==H####-H=H=$=H
H     E    H##HH     H=H=$=H
H    ##    H##H   $E  =H=$=H
H ###  ### H##==#####H=H----
H ###  ### H##       H      
H ###$$### H#     --$H #### 
H $ $##$ $ H##  H#  #H##$$##
############################
