# Level 50
~  --                  ~----
H    H                 H =  
H    H             E   H =$$
H $  H#### $   $H#####T#H###
H##  H   #########      HH#T
H    H                   HHT
H     H-------------------HH
H     H                    H
H     H $       E   $     $H
H     #####H==========##T##H
H---       H          ---   
   E$      H         H      
#########H H   $     H-   $ 
        #####H===H#### #$###
$       P    H   H   E #####
#############H   H##########
