# Level 51
#=#==#             ~=#==###=
##==##             ~#==###==
   =#=#  $      $  ~#=     =
H#   =##=###=H##=  ~#= #=H =
H#=  =#==###=H ## $~=  #=H  
H##     =##==H  #=### $#=H  
H=##$    #==#H        ##=H$H
H#=####   =##H         #==HH
H ==#=##$  #=H $       #=  H
H     H##   ==#==#=    #=  H
=###==H=##            $#=  H
#=#===H#=##$   E    $###=  H
   $  H==###T======T###==H##
H#=###==   E         P   H=#
H=###=  H##==#==##=#==##===#
H   $   H            E   =#=
