# Level 52
         H                  
         H      $    E      
----     ~     ============H
H  =======                 H
H         -----  ----- H====
H---------        H    H    
    E             H#   H    
H==================#   ====H
H                         HH
H      $            E  =  H 
====##====H #==#========  H 
          H               H 
          H               H 
H========== ========      H 
H                   ------H 
H          P                
