# Level 53
                           ~
         E     E        $ $~
      H##############  H####
      H ############  H#####
H######  #$##$##$##  H######
H#######            H#######
H#############T#########    
H########$ $    $ $##### $$ 
H#########T###T#############
H       E          $######  
H  H#####H#####H  -H####  $H
H  H  H  H  H  H   ###  $H##
H  H$$H$$H$$H$$H   #  $H####
H  H#####H#####H    $H######
H              P   H########
H###########################
