# Level 54
~              #############
~  $     $     #############
##############H  $          
###########################H
     $ E   E $             H
H###########################
H        $          $       
###########################H
    $        $      $      H
H###########################
H   $  E E  E     $         
###########################H
   $      $      $      $  H
H###########################
H     $           $  P      
############################
