# Level 55
############~ ##############
#---------# ~  #---------#  
 #$  H  $#  ~   #$  H  $#   
  #$ H $#   ~    #$ H $#    
   #$H$#    ~     #$H$#     
    #H#     ~=====##H#      
 P  #H#     ~=   $ =H#  E   
###H#H######T#######H######H
   H H E            H      H
H##=#H##############H#=#####
H---#H#------------#H#      
H $# H #         $# H #     
H$# $H$ #       $#  H  #    
H# $#H#$ #   H###   H   # $ 
H $##H$#HH#=H#=#  E H  $ ###
#########H  H $#############
