# Level 56
$$$----$$$~$$$-----------$$$
###    ###H###           ###
###    ###H###           ###
###    ###H###    $$$    ###
###    ###H###    ###    ###
###    ###H###    ###    ###
###    ###H###    ###    ###
###    ###H###    ###    ###
###    ###H###    ###    ###
###$--$###H###$--$###$--$###
####$$####H####$$#####$$####
##########H#################
 ######## H ###### ######## 
  ######  H  #####  ######  
   E     PH         E       
############################
