# Level 57
#~##########################
#~------------------------ #
#~#===#===#===#==#=H#=---#H#
#~#    $    $   $  H   $H#H#
#~$H====================H=H#
#~#H#----------------= $H#H#
#~$H# ================####H#
#~#H# = $$$$$$$$$$$$   $#$H#
#~$H# =###======#=====H###H#
#~#H#     E           H$#$H#
#~$H#===========##====H# =H#
#~#H------------------  H#H#
#~#==##==H==#=#==H======H$H#
#~ E     H ==    H  E  $H#H#
#===#=###====H==#=#==##==#H#
 P           H            H#
