# Level 58
#####################     H#
# P##--- ==   $           H#
# #=  $ H==######HH H#H H H#
# #     H    ==# HH$H H H H#
# #H####=##$   # HH H H#H H#
# #H#      =##   HH H H H H#
#$ H#   $  #=# H# H~H H H ~#
##HH##T#=###=# H#$#~##H#H ~#
##H      E     H#T#~# H H ~#
##H##=#######=HHH #H# H H ~#
##H #=#######=HH  #H# H HEH#
# H  =  $    =H   #H#HH###H#
# HH#=#######=H $ #H#HE   H#
# #H#=#######=H===#~####  H#
# #H#     $  ==#   ~   #  H#
# $H #=========# E ~   #####
