# Level 59
  ~-- $        ~-$    $ ~   
  H  ##        H ##   ##H   
  H        $E  H        H  $
 $H--      ## $H  E$    HH##
##H  H$E     ##H  ##   $ H  
   $ H##       H      ## H  
  ## H- --E$---H         H  
  $    H  ##    $   $-   H$ 
 ##    H       ##  ## H$H## 
    -  H  $           H##   
   H ##H  ##   $      H     
 $ H     $    ## $    H$    
H##H    ##       ##   H##   
H                           
H             P             
############################
