# Level 61
          ~                 
          ~                 
 $ E $   =H=   -------- P   
H=###==# =H$          ####  
H=       =H=    $          $
H=----   =H=  ####---      H
H=      $=H=  $         $  H
H  $=###==H=###      H#### H
H=#==    =H=      E$ H#    H
H=       $H=   ########    H
H=    $  =H=   $        $  H
H=   =###=H=--####--  H##  H
H=$      =H=        $ H    H
H=##     =H=      #####    H
H     E   H                H
=###=####====###=####==##===
