# Level 62
##~####~#####~#####~#####~##
# ~$E  ~     ~   $ ~ $   ~ #
#H########T####T##########H#
#H#$       E$        $   #H#
#H#####T########T#######H#H#
#H#             $      #H#H#
#H#H####T####T#####T##H#H#H#
#H#H#                #H#H#H#
#H#H#H#$     E     $ #H#H#H#
#H#H#H###T##T###T#####H#H#H#
#H#H#H   $        $   H#H#H#
#H#H###T############T###H#H#
#H#H   $         $      H#H#
#H###T####T####T######T###H#
#H   E   $    P     $  E  H#
############################
