# Level 63
                  E        ~
###########################~
$ E     #       $  # $     ~
###H# #H#H######## #H# ##H##
###H#H#H#H#  $   # #H# ##H##
###H#H# #H# #### # #H#   H H
#$#H#H#H#H#H#P # # #H# ####H
#  H#H#H#H#H## # # #H# #H  H
 H#H#H#H#H#H  $# # #H# #H###
H### H#H#H###### # #H# #H  H
H## #H#H#H $     # #H -####H
H  -#H#H########## #H# #H  H
H## #H#H           #H# #H###
--# #H##############H# #H  H
     H      E       H# ####H
###################### E   H
