# Level 64
=~           ~            ~=
=~  E$$$$$$$$~$$$$$$$$$E  ~=
=============~==============
      $ $    ~     $  $     
    =H====   ~   =H=====    
     H$ $    ~    H$  $     
   ======H=  ~  =======H=   
      $ $H   ~     $  $H    
  =H======== ~ =H=========  
   H  $ $    ~  H  $  $     
 ==========H=~===========H= 
      $  $ H ~    $   $  H  
 =H==========~=H=========== 
  H                         
  H   $  $      P $   $    E
############################
