# Level 66
#######~------------~#######
######HH            HH######
#####HH     #EE#     HH#####
####HH    - #### -    HH####
###HH    - ###### -    HH###
##HH----- ######## -----HH##
#HH    - ####$$#### -    HH#
HH      ############      HH
#HH    - ####$$#### -    HH#
##HH    - ######## -    HH##
###HH    - ###### -    HH###
####HH    - #### -    HH####
#####HH    -    -    HH#####
######HH            HH######
#######HHE   P    EHH#######
############################
