# Level 67
~                           
~    #   E #       E   E    
~------$H#H ##H##~~#~~##H   
H      #H #H# H# $# $#  H   
H P     #  # H# H#  #   H   
#####    ## H#  #  #    H   
    #   $# H# $#  # --- H   
   #    # HHH #    #  #####H
 $#   $#  #HH#  ##  T      H
##    # $# H#  #  #  #     H
#   $#  # H#  #    #  #$   H
    # $# H# $#  H#  #$ #   H
  $#  # H#  #   H #  #  #  H
  # $# H#  #    H  #$ #  # H
 #  # HH     $  H   #     #H
      H##################  H
