# Level 68
======================~    =
=         E           ~    =
=    H#=##==#H=       ~    =
=    H      ~H=#=##==#~    =
= ##=H     H~H# # E#-------=
=$   H   $~H~## # =#      $=
=    H   H~H~#  #  #      E=
=H   H   H~H~# $#P #      #=
=H   H   H~=##  ## #     $#=
=H====T#==~=     # #     ##=
=H --------=     # #  $   #=
=H     $  H     ## #    ###=
=H  H=T===H===#H#  #   $#  =
=H  H=   =H=  #H####T#=# $ =
=H  H=   =H=$ #H        ##==
=H $H= E =H=#####==###=####=
