# Level 69
~ E ##          ------------
H#####       ##H            
H#####       ##H #=#=#=#=#=#
H#####       ##H $ $ $ $ $ $
H##$##       ##H#T#T#T#T#T#T
H##### $  E  ##H#T#T#T#T#T#T
H##############H------------
H##############H   = = = = =
H  P  E            #T#T#T###
H########H########H     T###
H########H   #####H####HT###
H########H##$  ###H####HT###
H########H####$  #H E  HT###
         H######  H####HT###
    $ $  H########H####HT###
##################H $$ HT###
