# Level 71
    ~                       
    ~              E        
    ~            H#####H    
 $H####H#HE      H#   #H    
#H#####H#####H##H######H###H
#H    =H $  =H =H  =# #H  $H
#H ###=H =# =H =H $=# #H ##H
#H $##=H   $=H =H # # #H ##H
#H ###=H # #=H =H ==  #H ##H
#H   $=H =   H$#H ##$ #HE $H
#H#####H#####HT#H######H###H
$H------- $$ H  E ##     =$H
===H    ##===##H==#$     $=H
   H### #=====#H======H====H
P  H# ##$$$$$$ H$     H    H
======####=======###########
