# Level 72
~                           
~      ------------------###
H    $E         H          #
H##T####        H          #
H      #        H $EH ## $ #
H $ H  # $   ---H###H#######
H###H  ##### $  H   H       
    H##########TH   H      $
H   H##  $ ####TH $#H-----##
H###H##########TH###H $ H ##
H     #         H#$#HT##H ##
H$EH  #     $   H###H   H ##
###H  #   $ ##  H###H   H ##
   H  # $ ##    H###H   H ##
   H P####    $ H###H  EH ##
############################
