# Level 74
     ~                      
     ~           ===========
=====~=====H----H          =
=    ~     H P  H   E      =
#####H######################
##H  H  H###    ####      ##
#HH#####H### ## ############
#H###### H## $# ### ##  ## #
#H# ### #H## ## ### $### $ #
#H## $ ##H##    ### ## $## #
#H#######H#########T########
#H  # #$ HH              EH#
#H####### H########H######H#
#H $###   H      ##H      H#
#H      E H   $  ##H   $  H#
############################
