# Level 76
###############            ~
#             #            ~
# ------------HH#######$   ~
#             H#     # #---H
#$ $E      P  H#     # #E  H
#H######H======#==   H  ## H
#H     #H      ###   H     H
#H$    #H-------   E #H    H
#H   ##=H      #######H   H#
#H  ##$=H    ###     #H#####
#H  #  =H  $##$# $$  #H## ##
#H##   =H  ##  #######H# # #
#H#$   =H ##   #-----#H## ##
#H     HHH#    #  $  #H#$# #
#H     H#H           #H## ##
############################
