# Level 77
~----      $$$$$$$     ----~
H    ##################    H
H ===##################=== H
H    ##################    H
HE#H ################## H#EH
==#H #    #    #    ### H#==
   H #$$$$#$$$$#$$$$### H   
   H ################## H   
   H ################## H   
   H ################## H   
   H ###    #    #    # H   
   H ###$$$$#$$$$#$$$$# H   
   H ################## H   
   H ################## H   
   H ################## H   
   H                   PH   
