# Level 78
#                         #~
#      $  E    ----------$#~
#############HH    E $  H##~
####         HH########### ~
#####  $  E  HH        ##  ~
#############HH  $    ###H ~
#######      HH########  H ~
   $  ##  $  HH     ###T#H ~
H############HH $  ##    H ~
H## # ####   HH##### $   H ~
H  H#H# $##  HH  #####T##H ~
===H H#H####PHH ## $     H ~
=====H H# ###HH#####T####H ~
=======HHH# #HH#         H ~
         H H HH          H ~
############################
