# Level 79
                     ~      
    E           =    ~   E $
H===== =======H==   #~#H####
H       ---   H=$##H#~#H####
##H## ##  H#E H ###H#~#H##$#
  H  ##$# H # H##  H#~#H####
H#   ####TH  #H  H###~#H    
H    P    H   #  H#  ~ ####H
H######## # $#  $H#H#######H
H########T# #  ####H##     H
H########T#     $##H  ######
H##$   ##T#----H# #H------  
H##   $##T#H   #  #$    # #H
H########T#H  #######H###$#H
H   ##$    H ##      H  ###H
H##########H###########    H
