# Level 80
      ------------$      ~  
======   ##      #======#H  
=------  $$      #      #H  
=H      ###T     # E   $#H  
=H$$    $  $     ######T#H  
====H   #T==           EHH  
    H       $    $   E-- H  
    H     #==========#-- H  
    H$E $ #E      $  #   H  
    H####H#######T####   H  
     #  #H               H  
     #  #H               H  
     #$$#H               H  
     ##T#H               H  
         H     E  P      H  
###=====###=====###===###===
