# Level 81
~                           
~                           
=======H               H====
       H   E         E H    
       H#######===#####H    
   #   H               H    
  #  --H               H    
  # $ $H    $#$     $$$H    
  # #$#H--  # # $$$ ###H--  
 #  #$#H$ $--$# ### #$#H$ $-
 #  ###H#$# $#$ $$$ ###H#$# 
 #    #H$#$ ### ### #$#H$#$ 
#     #H#$#         ###H#$# 
       H-H             H-H  
       H    P          H    
###===#########====#########
