# Level 82
============ ~ =============
=--------H#=-~-=#H---------=
=      $ H#--~--#H $       =
=   $  ##H-- ~ --H##  $    =
=  $##T-HH#=#~#=#HH-#T# $  =
= $##--H-#T-H~H-T#-H--###$ =
=$##--H-----H~H-----H---##$=
#T---H------H~H------H----T#
#---HE------H~H------EH----#
#   H######THPHT######H    #
# $ H       ###       H  $ #
H   H    E  #$#  E    H    H
H---H#T#####H H#####T#H----H
H $  H      H H      H  $  H
H    H  $   H H  $   H     H
############################
