# Level 83
 ----$                $ $P#~
     #H              H#####~
     #H             HT#####~
     #H            H#T##  #~
     #H           H##T##$ #~
 $ E #H          H#$#T##TT#~
####  #H        H# H#T##  #~
$   #$ #H      H# $H#T##  #~
###H #  ##H   H####H#T##  #~
$  #H #$ #H$EH# $ $H#T##  #~
##H #H #  ##H######H#T##  #~
$ #H #H #$ #H $ $  H#T##  #~
#H #H #H # #H##### H#T##TT#~
 #H #H #H          H#T##   ~
  H  H  H     E    H       ~
############################
