# Level 84
                      ~     
                      ~     
E       $#$           ~#$   
#####H########H#H##########H
$   #H $      H#H    #     H
###H#####H##########H#H#####
$  H     H  E       H#H    $
#H##############H###########
$H##$  #      $#H    E #$   
#########H#########H########
##H     EH###$ ##  H  ##  $#
##H####H#########H###H######
$ H####H# $#####$H###H    ##
##H####H#########H######H###
##H   #H     # P H  #   H  $
############################
