# Level 85
              E  $~         
         $  ######H# $      
     ###T####     H#####T#  
     #      #     H#     #  
     # E$   #     H#     #  
 ######## $ #$  #H#####$$#  
 #      ###T#####H    #T####
 #      #     $ #H E$    - #
 #      #    H########### H#
 #   $ $#    H#         $ H#
 #  #####    H# $  H#H H####
 ####   #  #H####  H###T#   
    # $ ####H   # $H#       
    #####  #H   ###T#       
            H      P        
=#=#=#=#=#=#=#=#=#=#=#=#=#=#
