# Level 86
~                          ~
~--------------------------~
HH                        HH
H  #T##    ###T##  ######  H
H  #  ##   #    #  #    T  H
H  #   ##  #       #       H
H  #    #  #       #       H
H  #   $#  #    $  #       H
H  #   ##  #   ##  #    $  H
H  #$ ##   #   $#  #$  $#  H
H  ####    ###T##  ##T###  H
H      P                   H
H H######  ######  #H####  H
H H#   $#  ######H #H##$#  H
HEH#    # E## $##H  H####  H
############################
