# Level 87
 ~                          
  ~                         
 #$    $#      $#     $#    
 $#    #$      #$     #$    
 #$    $#      $#     $#    
 $#    #$      #$     #$    
 #$    $#      $#     $#    
 $#    #$      #$     #$    
 #$    $#      $#     $#    
 $#    #$      #$     #$    
 #$    $#      $#     $#    
 $#    #$      #$     #$    
 #$    $#      $#     $#    
 $#    #$      #$     #$    
P#$    $#     E$#  E  $#  E 
############################
