# Level 89
=~#===#==##=##==#= ==#==##=#
=HHHHHH=H=#==# =H~~~~H==####
=H P $H=H $$$   H  E H $  ~#
=H=#=#H=H#=##=H#H=###H####~#
=H $  H=H $$$ H H $##H###=~#
=H=#=HH=H ### H H ==$H$##$~#
=HHH~ $=H     H$H  #=H=#==~#
=H  ~##=H  $  H=H  $ H    ~#
=H$ EH =H ### H=H  #=H  $=##
=H####H=H  #  H$H  # H ##$ #
=H  = H=H~~~~~H=H  # H   =H=
=H  = H---------H$E# H=$$$H#
=H  =$H=####H $=H###########
=H  =#H=   #####=#=       H#
=H $  H  $   $       E $$$H#
=######=#=================H#
