# Level 91
              ~             
              ~             
              ~             
 ------   E  H#H  E   ------
      H---H#$H#H$#H---H     
 H#$ #H   H#######H   H# $#H
 H####    H-H# #H-H    ####H
 HH##       H###H       ##HH
  H##       H# #H       ##H 
  H##       H###H       ##H 
  H##       H# #H       ##H 
  H##       H###H       ##H 
  H##       H# #H P   E ##H 
  H#########H###H#########H 
$ H##   $ #HH $ H# $   ##H  
===============H============
