# Level 92
                        ~   
               $     #E#~#  
      H---H########### #~#  
$ ----H    #      $  # #~#  
#H         #    ###### #~#  
##H      E #    $      #~#  
###H     $ #     ----- #~#  
####H -----#$  $#    H  ~   
======H    ######    H--~   
      H    ######    H #####
      H    ######    H #$ E 
      H    ######    H ####H
      H              H     H
    --H              H     H
E $#  H      P       H     H
####  H##$########## H  ####
