# Level 94
$  ############~############
H#---    -   $#~#          #
H#$# #### #####~#H###H####H#
H#$# #  #   $ #~#H###H####H#
H#$# #$$#######~#H  #H E$#H#
H#$# ##########~###H#H####H#
H#$#  $    E   ~  #H#H####H#
H#$#####H####$ ~ $#H#H    H#
H#$#    H   #######H######H#
H#$#H###$##H $    #H   $ #H#
H#$#H# $  #######H########H#
H#$#H H##HE$    #H    $  #H#
H#$############H########H#H#
H#$#$  # $ # $ H  #   $ H#H#
H#T#H#H#H#H#H######H######H#
H $ H#H$H#H$H#P $  H  $   H#
