# Level 95
  ~                         
  ~                         
  ~      -----        -----H
 EH    - E    H  -- EH     H
T#H---H #T##  H##  ##H ##T##
T#    H##T### H##  ##H ##T# 
T#    H##E-   H##  ##H ##   
T#    H##H ## H##  ##H- #   
T# $  H##H$## H##$ ##$HTT$P 
T --H-H##H ## H##  ## H#### 
## HH  ##H  # H##  ## H#### 
##HH   ##H T -H##  ## H##   
##H    ##H ##  ##  ## H##   
##H $--##H  $   # $#  H   $ 
#####H ######H  ##T#  H####H
#####H $#### H  $#T$  H#####
