# Level 96
~-~ E   ####~E  $   ####   ~
H H####H####H###### #######H
H H####H  $ H###$## ####$##H
H H#$$#H###########    ####H
H #####H     --------------H
H     #HE        $  $       
H  #H #H#####T#######H $ $  
H  #H #H----- -----H========
## #H #H    $ $    H  P$ $  
   $H #H#####T#####H#######H
##H== #H           H       H
##H   $H    $     =######H H
##H##############~=    $ H H
$#H#             ~=#####T# H
##H#     $    $  ~=    E   H
############################
