# Level 98
=~                         =
=~==== =========#=========$=
=~    $   $----   --------H=
=~       H##  #####     ##H=
=~     $ H       $#  # $#$H=
=~    ###H  $ P  ##  #T##=H=
=~  $    H#####H  # E     H=
=~ ###   H#   #H  #---H####=
=~     E H#$  #H  #   H--- =
=~   H#########H###   H  $ =
=### H#$ # $  #   #   H ###=
=$ ##H#########   #   H #  =
=####H---$$=$$#$  ##===H=##=
=   #H  ###=#####H#    H  $=
= $ #H    $      HH  E H#H =
#####H############H#########
