# Level 99
  ---      $  $    ---  = #~
##  #H    H####H  HE  ##=  H
 ## #H   H##########H ##= #H
##  #H#####$##$#####H #$=##H
$##$#H     E        H     #H
#################T#########H
   $ E   $          P   E  H
================H###########
 ------------- =H           
H      -      H=H           
H     - -     H=## ## ## ##H
H    - # -    H============H
H   - ### -   H------------H
H  - ##### -  HT#T#T#T#T#T#T
H - ##$$$## - H=            
H- ######### -H=       E    
