# Level 100
                 E E E-~   ~
               H###### H###H
               H#    # H###H
           H######   # H###H
           H#    #   # H###H
       H######   #$$$# H###H
       H#    #   ##### H###H
   H######   #$$$#     H###H
  EH#    #   ##### H#######H
######   #$$$#    EH#    ##H
#    #   ##### H######   ##H
#    #$$$#     H#    #   ##H
#    ##### H##### $$$#$$$##H
#$$$$#     H#======#===#===H
###### H#####        P     H
       H####################
