# Level 102
---------    ~      -----   
         H    H    H        
   ------H $   H   H        
  H $ E  ###   H    H       
  H ####      H ---  H $$-- 
  H          H   $   H ==   
  H----   $ H    =  H      $
       H ## H      H       #
       H     H     ===###=##
       H      H --          
   $E$ H       H         = =
  #### H----   H   ======= =
$        $$   H $      $ $E=
=        ##  H  #  #########
           P H              
#####===#########===########
