# Level 103
-----------------------~    
  $    $     $     $   H    
####  ####  ###T  ##T# H    
     $    $      $     H    
#  #T##  ##T#  T###  # H    
 $      $   $      $   H    
####  ####  ###T  ##T# H    
    $     $     $      H    
#  ##T#  #T##  T###  # H    
  $     $     $    $   H    
####  ####  ###T  ##T# H    
E    P           E     H   E
########################~###
########################~###
######################  ~  #
###################### E~E #
