# Level 106
============~  ===       =#=
#######=##==~  ##=       #=#
   $  #=#=#=~  =#=       #  
H=###T#    =~ E #=      $# $
H####       H##=#=T#####H= H
H# $# ---=#=H#    T=####H# H
H###---  =#=H#----T=####H=#H
H##---      H=     $ ##=H##H
H#--$   ##=#H#    T##==#H##H
H-- #-------H         ##H #H
   =#E  $  =HT##= P $   H##H
##T#=## =##=HT##==#==#=    H
##T#=      =HT    E $ =#####
##T#=-------HT##  ####=  $ #
##     $   =H          #####
#=####=##H  H  H###=########
