# Level 107
~---------  P    ----------~
H    ---- #######  ----    H
H    --- ########## ---    H
H    -- ############ --    H
H    - #####$$$$##### -    H
H    - ############## -    H
H     ################     H
H     ##$$$$####$$$$##     H
H     ################     H
H     ######$$$$######     H
H      ##############      H
H    - ############## -    H
H    -  #$$$$##$$$$#  -    H
H    --  ##########  --    H
HE$$$---$  ######  H---$$$EH
#########H$$$$$$$$H#########
