# Level 108
############    ######==###~
#--------------------- ## #~
# H#########H  ~#-----H----~
P H$H$$$$   H  ~#$  $$H   $~
##H#####=###H  ~###H###T#H#~
# HHHHH =  $H  ~#$ H-----H ~
#$  =$H  $$#H  ~#= H === H$~
#######T####H  ~#$ HE  $$H=H
#  $=$$ =  #H  ~######H####H
#  ==== =  #H--H#$    H  $$~
# $$$ $$=$ #H$EH#=$   H ###H
#H###T####H#########H######H
#H--------H### -----H-= ---H
#H $  $$$ H  $H $ $ H =H$ $#
##H##H=#H###T#H##=#T#####H##
 $H$$HE H     H        $$H$$
