# Level 110
      =-------  --- ~~##~  ~
$   E$=------$##   HH##HH  ~
###H##=     $##   HH##HH$  ~
   H  =    $##   HH##HH$ ==~
$  H $=   $##   HH##HH$ == ~
###H##=  $##   HH##HH$ ==  ~
  PH  = $##   HH##HH$ == $$~
###H $=$##   HH##HH$ == H## 
###H##=##   HH##HH$ ==  H$$ 
#$#H  = $  HHE HH$ == H#### 
###H $=###########H=  H$ E$ 
$##H##=-----------H= H##### 
###H $=$ $  H      = H$   $ 
#======###  H #### = H##### 
           EH##$$##= H$   $ 
############=######= #######
