# Level 111
            ~~~             
           HHHH             
             HH             
  E         HHHH         E  
-----------HHHHHH-----------
-----------HHHHHH-----------
 ----------HHHHHH---------- 
   --------HHHHHH--------   
     ------HHHHHH------     
        ---HHHHHH---        
$ $ $ $ $  HHHHHH  $ $ $ $ $
           HHEPHH           
###########HH##HH###########
###########HH##HH###########
 $ $ $ $    H  H    $ $ $ $ 
############################
