# Level 112
                     ======H
--------------  E          H
H            H======= H# H~#
H EH=H       H-----H #H #H  
=====H=H= P        H  ##  #T
H----H H#T###=== ##H ##H  #T
H    H H# $#   $   H # H#--T
H      H#  $#### ==H $H#$ $$
H      H# E#####   H #H#   #
HT$     # #####$ ==H~~H#H###
H #     # $##### $ H  # H## 
H  #    # ###### H=H ###H ##
H   #   #H $#$ # H H  # H# $
H    #   H###### H=H # ## ##
H       #          H        
##===#########====#=#===#===
