# Level 114
       --~        ~--    -- 
 ######$-H########H-$####$- 
 #######$H########H$######$ 
 ########H########H######## 
 ### ####H###     H###   ## 
 ###  ###H###$$$  H###$$$-- 
 ###  ###H######  H######$- 
 ###  ###H######  H ######$ 
 ###  ###H######  H  ###### 
 ### $###H###     H     ### 
 ###$####H###$$$$$H##$$$### 
 ########H########H##T##### 
 ####### H########H #T####  
 ######  H########H  T###   
  E   E  H   P    H   E   E 
######### ###HH### #########
