# Level 115
                           ~
-------- #H            $  $~
   $#$  H#H#=#=#=#=#=T=#=#=#
  $# #$ H#H    $   $        
 $#   #$H##=#=#=#=#=#H      
 #     TH#===========H      
        H----------H###T###H
                   H#      H
  $ P$             H#      H
H#######H E $  $   H# $  $EH
H E$  $ H#=#=#=#=#=#==#=T=#H
H#######H######$ ###       H
H  $ $  H######## ##       H
H#######H######### #       H
H   $ $ H##########  $  $  H
############################
