# Level 116
##~#=#=#=#=#==# #~#= ##~####
##~######=#==H= =~=# # ~  H#
#=~      #=  H   ~ $  E~  H#
###T##H------H##T#########H#
 P $  H$H#=$ H =  =#=  #  H#
#####H##H=#=  $ =    = ---H#
  =# H= H===#==# =  -----#H#
$ E  H  H  #            ##H#
#T=##H  H$==#$ #=$     ## H#
=T = H  $=#==#$ =#---H#   H#
  #  H $= $$$ =$  =  H    H 
H----H$= H#=#  =$   #H######
H H  ==--H      =  $ H =====
H H#=#$$ H--H  H ####H  =  #
H H$ $##$E$$H--H  ##=H   E$#
############H $H$###########
