# Level 117
            ###            ~
    $  E $  ===     $E  $  ~
H##############H############
H---------- ===H            
           H###H  --------- 
 ----------H===H$          H
H $  ----P  ######       $H#
#####    #H ======    E$H###
  - #    #H ######   $H#####
##$H#    #H ====== $H#######
$##H#    #H----- $H#########
##$H#    #H === H===========
$##H# $$ #H ### H           
##$H####T#H === H##########H
$##H  E   H$###$H#$        H
############===###==========
