# Level 119
                        ~   
   $                    ~   
H=##                    ~==H
H=$## $                $~==H
H  #$###          E #######H
H  # #  ###$     ### $     H
H--  #$ #  #  $ ##$ ====   H
H  ######   ###T#      ###=H
H$ P                 H# $  H
H====---------       H###$ H
H   =     E$$$$      H  ####
H $ =$  ==========   H $=  $
H#####               H##==##
H----H------         H      
     H               HE     
     H   ###################
