# Level 120
             ~              
             ~              
         H   ~            H 
   ######H   H------------H 
   #  $ #H   H          E H 
   #    #H   H======##==##==
=#==#==#==#==H#-----#T###  #
 $E $     $  H# H   #-- #  #
#######T#####H# H#$$#$#H#$ #
 ------------H# H####T#H#  #
HE          PH# H$   --HHH##
H############H######H $  H  
H            H      H##  HHH
H$##### $ ###H## $ #H#$--  H
H## $ #####$ H #####H##$ ##H
####################H  #####
