# Level 122
~                           
~      E          $         
~ ==H====         ====H=====
~   H    #$      #    H#    
~---H-----#     #-----H=H  $
#$  H  $   #   #      H#H-- 
 #E H--- #H # #   $   H=   H
  #     # H  T        H#$  H
P  #   #  H         $ H= --H
==# # #   H# ------ # H#H   
    #T    H # $    #  H=H E 
$ ###     H  #    # $ H####H
#H=-------H   #  #  ##H####H
 H             TT     H    H
 H                    H    H
=======######====####=======
