# Level 123
              ~             
   --------  -~---          
  H        H-     H H####H  
  H-------EH------ H# H- #H 
  H       H#  --- H#  H $ TH
  H      HT #H   H#   H   $#
  H  -- H    #H - P---H----#
H #HH~ H#$H## #H  #        #
H# #H~ H#######H  #### #####
##T##~ H#  #$ #H-H    -   EH
##T##~ H#######  H#### ####H
# $ #~ H# $#  #H H# ## ####H
#####~ H#######H H#### ##$#H
#####~ H#  #$  H H#    #   H
#   #~ H#######H H##T###T##H
# $  ~#H      #H#H   #  $  H
