# Level 124
~                          ~
~                          ~
~-----H     H------H#     #H
      H-----H      H#     #H
 $    H     H E $  H#####T#H
### $ #HH   #############T#H
####### H            $     H
#####$  H##   $#$   ##     H
######$ H##  $###$  ##     H
#######$H## $#####$ ## E $ H
########H##T###########H==#H
#      EH              H ##H
#  $  ##H       P      H ##H
########H----H####H$---H ##H
#       H  $ H##$#H#  #H$##H
##################H####H###H
