# Level 125
     -----         ~    -   
 ###      H--   E  H####    
 #$      H-- ######H####    
 ###     --  T####TH#$$#    
     ###T    T####TH####    
     ###T ##-T#$$#TH    T###
     #$$T ## T####TH    T###
     ###T          H    T$$#
                   H    T###
                   H        
T###T              HT###    
T###T              HT### ## 
T $ T              HT$$# ## 
T###T              HT###    
              E    H P      
############################
