# Level 126
~  $ ~    - -  E  ~-      -~
H### H####$#$#####H -    - E
H  $ H############H -$ - $ H
H### H##$#####$###H-  - - -H
H  $ H############H $   $  H
H### H#$#######$##H --  -  H
H  $ H############H - $ -$-H
H### H##$#####$###H   -  - H
H  $ H############H  - -   H
H### H###$###$####H-  - - -H
H  $ H############H  $   - H
H### H####$#$#####H   -- $ H
H  $ H############H -  - - H
H### H###$###$####H $ - - -H
H E  H############H     P   
H####H##$#####$###H#########
