# Level 128
~-                        -~
H ######################## H
H #    #  $  $#       #  # H
H # $  ####T###       #  # H
H #T####     # $E $   # $# H
H #   #      ############# H
H #   #      #      #    # H
H #####  $ E #      #    # H
H #   #########     #  $ # H
H #      #    #$    ##T### H
H # $  $ #    #######    # H
H ###T####    #   #      # H
H # $ #$   E$ #$  # $    # H
H ###T##########T######T## H
H           P      E       H
############################
