# Level 129
   ~         ~~         ~   
  EH         HH         H E 
 ##H##     ##HH##     ##H## 
##$H$##   ###HH###   ##$H$##
#  H     ##$ HH $##  #  H   
## H  ---##  HH      ## H   
 ##H##   ##$ HHE$     ##H## 
  $H$##   ###HH##      $H$##
   H  #    ##HH### --   H  #
##$H$##    $ HH $##  ##$H$##
 #THT#       HH  ##   #THT# 
   H     ##$ HHE$##     H   
          ###HH###          
           ##HH##           
        P    HH             
#############HH#############
