# Level 130
H                           
H  --      -----------------
H   ~     $H    $    H   E H
### #######H-------H H H====
 T         H $     H H H    
===H### E  H-------H H ====H
   H $ #####    $  H H     H
 P H #####$#-------H H H====
H# H---------------H H H    
H#######T#####   E   H ====H
H$  ####     #   ####H     H
H#############== ######H####
H=############   ######H###$
H=############H= ##$###H####
H= $##########H=       H    
H ######T     H=############
