# Level 132
#~                         #
#~-------------------------#
#~       T###H###T         #
#~    $T#T   H   T## $     #
#~  $T#T$$$$$H$$E$$#T# T   #
#~ ##T#T#####H######T#T# $ #
####         H         #T#T#
##     $$$$  HE $$$$     #T#
#    H######TH#######H     #
#    H       H       H     #
#   $H  $$$$$H $ $$$$H E   #
# HT#########HT#########H  #
# H          H          H  #
# H          H          H  #
# H          H  P       H  #
############################
