# Level 134
@ 0,0
$E     #####################
##H    #####################
H####H    ##################
H#######H E  ###############
H##### ####H    ############
H##### #######H    #########
H##### ##########H E  ######
H#### $ ############H    ###
H####### $ ############H    
H##### #### $ #############H
H##### ####### $ ##########H
H##### #########H $ #######H
H##### #########H### ######H
H$   $   $   $ #H### ######H
##############  ####      PH
############################
