# Level 136
                     EEE~   
                  $$$$$$~   
           $$$$$$~#######   
    $$$$$$~=======          
   ~#######                 
   ~~                       
    ~                       
$$$$~                       
####H                       
##########H                 
###############H            
###################H        
######################H     
########################H   
#########################H  
#########################HP 
