# Level 137
~                           
~   $   $   $E E$   $   $   
############## #############
              H             
             #H#            
             $H$            
   E        ##H##       E   
   H        $ H $       H   
  #H#      ###H###     #H#  
  $H$      $  H  $     $H$  
 ##H##    ####H####   ##H## 
 $ H $    $   H   $   $ H $ 
###H###  #####H##### ###H###
$  H  $  $    H    $ $  H  $
   H          H P       H   
############################
