# Level 138
             ~              
             ~              
          E  ~  $---        
 --------H====#T##  H       
H        H          H       
H      ######===#######     
H      #$ #   #   #   #     
H E $$ #  #  $# $$# $$# $   
H#######  ################# 
H#  # #####     #           
H# $# $  #   H$ # P         
H###########=H=#######T#####
H            H          --- 
H            H         H    
H        $   H         H ###
#############H    $ E  H  $ 
