# Level 139
~               ~  =####    
~###############~  = $H# $  
~-----------H  #H--=##H# ===
$H#=#     $ H--#H   $ H#   H
=H   ##     H  #H  =##H#  $H
=H##  $#   PH  #H $=E H#H--H
HH $########H  #H  =#H##H  H
H  ###     =H  #H    H  H $ 
H   ##     =H  ##H   H  H###
HH   ######=HE  ###H H  H   
=H###------=##H   ###HH H##H
#H    E       #=H   ##H#   H
#H#######H      #=H   H#   H
#H##$####H#####H###==HH### H
#H#####$#H#####H$  $ HH#$  H
#H###################H#####H
