# Level 142
-----------~          ~     
  $  $  $  H     #   -~-    
          EH---- #### H ####
###########~    H#### H T###
$$       $$~----H#### H T###
##$     $##H     # ## H T$$#
###$   $###H---- # ## H T###
####$ $####~    H# ## H T$$#
#####$#####~ E  H# ## H T###
###########H######$$# H T$$#
           H     #### H T###
# #    P   H         EH T$$#
# ###########H##########T###
#     ###$###H#####$        
#     ####$##H##$ $##H     $
# $  $#####  H  ############
