# Level 143
########~###################
P =  ===~   =H #   H------- 
#H   H =H== =H$#H==H        
$H==#H =H==  H  H           
##H  H =H  ###H=H-----    $ 
$=H##=$=H##---H=H           
  H    =H= $= H=##   $  ####
 EH  $ =H=####H= H       E  
==##H# =H=    H--H==========
H  =H#  H=###### H   =-----=
H#  H###H= $#$  ###H = H   =
H= H== =H=  #      H   H   =
H= H= $=H   ###########H=  =
H ### ==H=###          H   =
H    E  H=$ =H $    $  H   =
#########=##$H==####===H  $=
