# Level 146
#   ~-     P    -~   # $   ~
####H ########## H#### ####H
####H #  ##### # H###    $ H
#$##H # #####  # H##$# H####
####H #  ##### # H#### H$   
##$#H # #####  # H#$## ####H
####H #  ##### # H####    $H
#$##H # #####  # H#### H####
####H #  ##### # H ### H $  
##$#H # #####  # H#### ####H
####H #   #### # H#$##  $  H
#$##H #$#####$$# H#### H####
####H ########## H##$  H  $ 
##$#H ########## H#### ####H
####H  E     E   H####  E  H
############################
