# Level 148
            ~~              
         EE ~~ EE           
        $$$~##~$$$          
  $$$$$~==========~$$$$$    
 ~######          ######~   
 ~HH                  HH~   
   H                  H     
   H                  H     
   H                  H     
   H                  H     
   H                  H     
   H                  H     
   H                  H     
   ~                  ~     
   ~          P       ~     
=######=####==####=########=
