# Level 150
~----  ~     EP     ~  ----~
H    ##H$          $H##    H
H    ##H$          $H##    H
H     ##H$        $H##     H
H$ $  ##H$        $H##  $ $H
H####H ##H$      $H## H####H
H$  $H ##H$      $H## H$  $H
H#####H ##H$    $H## H#####H
H$E E$H ##H$    $H## H$E E$H
H######H ##H$  $H## H######H
H$    $H ##H$  $H## H$    $H
H#######H ##H$$H## H#######H
H$     $H ######## H$     $H
H########H ##=T## H########H
H$      $H $$#T$$ H$      $H
#############==## ##########
