# Level 151
       ##~        ~##       
       ##~        ~##       
         H#      #H         
        EH#      #HE        
       H###$####$###H       
       H############H       
     #H##  ##==##  ##H#     
     #H## $######$ ##H#     
   $##H###H#====#H###H##$   
   ###H###H######H###H###   
   ## HH##H#====#H##HH ##   
   ##  H##H######H##H  ##   
   ##  H#          #H  ##   
   ##  HH          HH  ##   
         H##H  H##H         
         H##HP H##H         
