# Level 152
           #######         ~
          HHHHH####        ~
         HH E   E ##       ~
        #H  =   =  ##      ~
        #H === === ##      ~
        #H === === ##      ~
        #H === === ##      ~
        #H  =   =  ##      ~
        #H    $    ##      ~
         #H   $   ##       ~
H---------HH     ##--------H
H---------HH # # ##--------H
H  $  $  $HH # # ##  $  $  H
H         HH # # ##        H
HP        HH H H ##        H
============######==========
