# Level 153
 ~  H-----   E           ~  
 ~  H    #########       ~  
 ~  H    #$-----$# H--   ~  
 ~  H    #=H   H=# H  -- ~  
 ~  H    # H   H # H     ~  
 ~  H $  #$-----$# H $   ~  
 ~$EH =  #  ===  # H = E$~  
####H    #       # H   #### 
----H    T =    =T H   ---- 
    H    #=H=  = # H        
    H$   # =     # H$       
   ####H #       # ####H    
       H #   TT  #     H    
       H ####TT###     H    
  P    H               H    
##########=======###########
