# Level 154
~------- ####### ----------~
H       #########          H
H     E##       ##E        H
H     ## ####### ##        H
H     ##T#######T##        H
H     ##    #    ##        H
H     ##$  ###  $##        H
H    ####### #######       H
H    ###### # ######       H
H    ###TT ### TT###       H
H     # $ ##### $ #        H
H     #############        H
H    ######   ######       H
H    ### $#   #$ ###       H
H     ##  ## ##  ##        H
###HP  HH### ###HH    H#####
